XXXXXXXXXXXXXXXXXXXXXXXXXXXX
XP           XX            X
X XXXX XXXXX XX XXXXX XXXX X
X XXXX XXXXX XX XXXXX XXXX X
X XXXX XXXXX XX XXXXX XXXX X
X                          X
X XXXX XX XXXXXXXX XX XXXX X
X XXXX XX XXXXXXXX XX XXXX X
X      XX    XX    XX      X
XXXXXX XXXXX XX XXXXX XXXXXX
XXXXXX XXXXX XX XXXXX XXXXXX
XXXXXX XX          XX XXXXXX
XXXXXX XX XXXX XXX XX XXXXXX
XXXXXX XX X   G  X XX XXXXXX
          X G    X          
XXXXXX XX X   G  X XX XXXXXX
XXXXXX XX XXXXXXXX XX XXXXXX
XXXXXX XX          XX XXXXXX
XXXXXX XX XXXXXXXX XX XXXXXX
XXXXXX XX XXXXXXXX XX XXXXXX
X            XX            X
X XXXX XXXXX XX XXXXX XXXX X
X XXXX XXXXX XX XXXXX XXXX X
X   XX       G        XX   X
XXX XX XX XXXXXXXX XX XX XXX
XXX XX XX XXXXXXXX XX XX XXX
X      XX    XX    XX      X
X XXXXXXXXXX XX XXXXXXXXXX X
X XXXXXXXXXX XX XXXXXXXXXX X
X                          X
XXXXXXXXXXXXXXXXXXXXXXXXXXXX