XXXXXXXXXXXXXXX
XP           GX
X X  XXXX  X XX
X X  XXXX  X XX
X X  XXXX  X XX
X        G    X
X X  XXXX  X XX
X X  XXXX  X XX
X X  XXXX  X XX
X      G      X
XXXXXXXXXXXXXXX