XXXXXXXXXXXXXXXXXXXXXXXXXXXX
XP           XX            X
X XXXX XXXXX XX XXXXX XXXX X
X XXXX XXXXX XX XXXXX XXXX X
X XXXX XXXXX XX XXXXX XXXX X
X                          X
X XXXX XX XXXXXXXX XX XXXX X
X XXXX XX XXXXXXXX XX XXXX X
X      XX    XX    XX      X
XXXXXX XXXXX XX XXXXX XXXXXX
XXXXXX XXXXX XX XXXXX XXXXXX
XXXXXX XX          XX XXXXXX
XXXXXX XX XXXX XXX XX XXXXXX
XXXXXX XX X   G  X XX XXXXXX
X                          X
XXXXXXXXXXXXXXXXXXXXXXXXXXXX