XXXXXXXXXXXXXXXXXXXXXXXXXXXX
XP                         X
X XX X XXXXX XX XXXXX X XX X
X XX X XXXXX XX XXXXX X XX X
X XX X XXXXX XX XXXXX X XX X
X                          X
X XXXX XX XXXXXXXX XX XXXX X
X XXXX XX XXXXXXXX XX XXXX X
X      XX    XX    XX      X
XXXXXX XXXXX XX XXXXX XXXXXX
XXXXXX XXXXX XX XXXXX XXXXXX
XXXXXX XX   G      XX XXXXXX
XXXXXX XX XXXXXXXX XX XXXXGX
XXXXXX XX XXXXXXXX XX XXXX X
X                          X
XXXXXXXXXXXXXXXXXXXXXXXXXXXX